1111111111111111111
111111PCE1111111111
1111111111111111111
1111111111111111111
