1111111111111111111111111111111111111
111111P00000C000C00000011111111111111
1111110011111111111111011111111111111
100000000C0000001C1111011111111111111
1000011111100000001000011111111111111
1111111111111000100011111111111111111
11111111111111E11011111111111C1111111
1111111000000000000000000000001111111
1111111111111111111111111111111111111
